00000000000000000000
00000000000000000000
00000000000000000000
00000000000000000000
00000000000000000000
00000000000000000000
00000000111100000000
00000000144100000000
00000001124110000000
00000001223410000000
00000011232211000000
00000012213321000000
00000012252221000000
00000011111111000000
00000000000000000000
00000000000000000000
00000000000000000000
00000000000000000000
00000000000000000000
00000000000000000000