00000000000000000000
00000000000000000000
00000000000000000000
00000000000000000000
00000000000000000000
00000011111110000000
00000012544410000000
00000012222211000000
00000111322221000000
00000122222221000000
00000123213121000000
00000122212221000000
00000111111111000000
00000000000000000000
00000000000000000000
00000000000000000000
00000000000000000000
00000000000000000000
00000000000000000000
00000000000000000000