00000000000000000000
00000000000000000000
00000000000000000000
00000000000000000000
00000000000000000000
00000000000000000000
00000111111100000000
00000144442100000000
00001114443111000000
00001223132321000000
00001233221321000000
00001222212221000000
00001111252111000000
00000001111100000000
00000000000000000000
00000000000000000000
00000000000000000000
00000000000000000000
00000000000000000000
00000000000000000000