00000000000000000000
00000000000000000000
00000000000000000000
00000000000000000000
00000000000000000000
00000000000000000000
00000011111111000000
00000012222221000000
00000012133221000000
00000012444121000000
00000011444321100000
00000001211232100000
00000001322322100000
00000001221225100000
00000001111111100000
00000000000000000000
00000000000000000000
00000000000000000000
00000000000000000000
00000000000000000000