00000000000000000000
00000000000000000000
00000000000000000000
00000000000000000000
00000000000000000000
00000000000000000000
00000001111100000000
00000111222111100000
00000122232322100000
00000123222325100000
00000111331111100000
00000001224410000000
00000001444410000000
00000001111110000000
00000000000000000000
00000000000000000000
00000000000000000000
00000000000000000000
00000000000000000000
00000000000000000000