00000000000000000000
00000000000000000000
00000000000000000000
00000000000000000000
00000000000000000000
00000111111111000000
00000122211221111000
00000123222222221000
00000113111211221000
00000122112921211000
00000123444444210000
00001121112421210000
00001222223111310000
00001222122223510000
00001111131211110000
00000000122210000000
00000000111110000000
00000000000000000000
00000000000000000000
00000000000000000000