00000000000000000000
00000000000000000000
00000000000000000000
00000000000000000000
00011111111100000000
00012221122111100000
00012322222232100000
00011311121152100000
00012211292121100000
00012344444421000000
00112111242121000000
00122222311121000000
00122212222321000000
00111113121111000000
00000012221000000000
00000011111000000000
00000000000000000000
00000000000000000000
00000000000000000000
00000000000000000000