00000000000000000000
00000000000000000000
00000000000000000000
00000000000000000000
00000000000000000000
00001111111111100000
00001222212222100000
00001235333332100000
00001222222222100000
00001111121111100000
00000001422100000000
00000001422100000000
00000001444100000000
00000001422100000000
00000001111100000000
00000000000000000000
00000000000000000000
00000000000000000000
00000000000000000000
00000000000000000000