00000000000000000000
00000000000000000000
00000000000000000000
00000001111100000000
00000001252100000000
00000001232100000000
00000111242111000000
00000122292221000000
00000129999921000000
00000122292221000000
00000111393111000000
00000001242100000000
00000001292100000000
00000001242100000000
00000001111100000000
00000000000000000000
00000000000000000000
00000000000000000000
00000000000000000000
00000000000000000000