00000000000000000000
00000000000000000000
00000000000000000000
00000000000000000000
00111110111100000000
00144410122111100000
00144411122322100000
00144441123223111000
00114444112223221000
00111444211232321000
00121122221223221000
00122112121112111100
00123212132232222100
00122352232222322100
00122212323323211100
00122111111221110000
00121100001111000000
00111000000000000000
00000000000000000000
00000000000000000000
