00000000000000000000
00000000000000000000
00000000000000000000
00000000000000000000
00000000000000000000
00001111001111110000
00001221111222210000
00011922292992210000
00012329222291210000
00012422211122210000
00011111122215110000
00012924292299210000
00012221222122210000
00011922292131210000
00001221111122210000
00001111000111110000
00000000000000000000
00000000000000000000
00000000000000000000
00000000000000000000