00000000000000000000
00000000000000000000
00000000000000000000
00000000000000000000
00011111111111111000
00014222222222221000
00014323232323221000
00014111111111221000
00014149232443911000
00014123232943510000
00014142232443310000
00014111111111410000
00014222222222210000
00014131313131310000
00014222222222210000
00011111111111110000
00000000000000000000
00000000000000000000
00000000000000000000
00000000000000000000