00000000000000000000
00000000000000000000
00000000000000000000
00001111111111111000
00001223232349441000
00001232323294441000
00001223232349441000
00001232323294441000
00001223232349441000
00001232323294441000
00001223232349441000
00001232323294441000
00001223232349441000
00001532323294441000
00001111111111111000
00000000000000000000
00000000000000000000
00000000000000000000
00000000000000000000
00000000000000000000